Boehner|mind control|Obama|psychic|shield
RealSexEdSavesLives!|condoms|PPNC|39|outreach|recognition|World|AIDS|day
Amanda Ben|Hyde UTD|police
steelers|steelernation|obama
Day|river|roadrapers|imonaboat|85degrees|itsnovember?|globalwarming|brudders
Holister|models|holister|models|hottie|mall|blackfriday|shopping|abs
decemberwish|BEROTOT
New York|ny|newyork|new|york|usa|timesquare|april|2012
brittanyybetch|highway|roadtrip|rude|newyork|red|car|ginny
police|fivepointoh|mustang
webisodes|police|jaredbrady|heavenkimchi
Obama|rocks|Jordans
sportlobstertashdash|79miles|cancer|movember
39|mom|cairo|airport|backk|welcome|home
go|homosexuality|sorrynotsorry|notoffensive|religion|truth
se|expresion|a|religion|culture
razor|NFL Gillette
thatshitcray|crazy|funny|hurricanesandy|brad
Sandy|Terra Nova Scout Group|meeting|pccrovers
Cairo
Nation|STD|HIV|AIDS Awareness|aids|aidsawareness|jci|jciphilippines
Obama
decemberwish
Obama|quot|Guy|quot|American Citizens|tcot|NDAAruling
39|don|39|t|football|gay|gayboy|gayboys|gayguys|gaylove|gaymarriage|freedom|kissgay|boyloveboy|lgbt|freelove|emokiss|gayrights
beautiful|lovo|my|dog|white|like|android|jj|followme
Brooklyn|flooding|hurricanesandy|Prayers|family|friends|northeast
UEFA Champions League|39|cup|UEFA|ChampionsLeague|FCBarcelona|FCB|Bara|CampNou|FCBMuseum|Messi
Obama|years|team|OBAMA|my|President|is|BLACK|JET
religion|Drugs|Buddha
DecemberWish|bedroom wallpaper|lolz|youwish
AugustWish|SeptemberWish|OctoberWish|NovemberWish|DecemberWish|FINALLY|TYL|34|34|34|34|34|34|Happiness
Hurricane Sandy|relief show|hotelcafe|rockdrive|friends|help|hurricanesandy
GOING|Awake|hours|Partyaaye|floor|shame|blackfriday|pearls|shopping|nomess|iwassnoringtoo|ohwell|hollahz|pagnit
OBAMA|LMFAO|Winning|Thug
SternShowComiX Howard AGT Round|MFBrooklyn|HOWARDSTERN|STERNSHOWCOMIX|zenabuddysgirl|southernjew
Relationship|Religion|morning
AFetusIsAHuman|antiabortion|allWomen|Abolionist|abortion|AbolishHumanAbortion|babies|ChildrenAreABlessing|EndAbortion|Fetus|Love|Miracles|ProLife|StopAbortion|SpeakLife|SaveOurBabies|NationalRightToLife|40dasporlavida|latinobaby|latinababy|40daysforlifeLR|40daysforlife|Prayer|BlackGenocide|blackbaby|whitebabies|BlackWomen|whiteWomen|LatinaWomen|ArkansasRightToLife
pitbull|Montreal|globalwarming
blackfriday|occupy|ola|tents
34|Accessories|LIFE|34|Religion|MercedesVision|Fendi|LVblanket|SF49ers|HallOfFame|S550|Blessed
MemoriesIWontForget||ElenaGornall1|EmilyStuart
World AIDS Day|Shibuya|japan|hiv|aids|shibuya|instadaily|instapic
Argos|Go|39|media beat|Grey Cup
abortion|tamore|1mother
thrift store|deals|bills|blackfriday
night|babyshower|cousin|auntie|lovethem|party|newyork|stophashtagging
newyork|brooklinbridge|nightime
girl|AGT|performance
win|championsleague|zenit
MemoriesIWontForget|One
DecemberWish|Less|Less|Less|Happiness|Laugh
gay|gayboy|gayboys|gayguys|gaylove|gayrights|gaymarriage|love|lgbt|kissgay|boyloveboy|freedom|freelove
Harry|39|christmas twitcam
Movember Mustache|november|movember|mustache|men|cancer|donations
Ep|lacartafaiR|le mini video d|39|remix|Jay Z|Obama History|version|dispo sur|TXhiXH|ler1er
scene|Tahrir Square|November|TIME|39|Bobby Ghosh|ghoshworld
pizza|pizza|food|foodporn|goodness|vodka|grandma|angelinas|newyorkpizza
truth|interesting|abortion|gays|america
Liverpool|players|World Aids Day
Schoolhouse Rock Election Collection Movie Online Schoolhouse Rock Election Collection|movie download Actors|movynsweinfo|movie|Schoolhouse Rock Election Collection Review|Michael Jacobson|BARNES|amp amp|Schoolhouse Rock|Election Collection|Walt|Schoolhouse Rock Election Collection DVD Movie Central SCHOOLHOUSE ROCK ELECTION COLLECTION|Schoolhouse Rock Election Collection Classroom|Buy|Download|Rent Schoolhouse Rock|Election|age|origins|Aspect Ratio|Description|Rent Schoolhouse Rock|Election Collection P|amp amp|S DVD|movies|Blockbuster|Video|vote|Schoolhouse Rock Election Collection|Schoolhouse Rock|Election Collection P|amp amp|S DVD Rental|Rent|anyone|parents|039|039|m|Bill|Election Collection Schoolhouse Rock Movie Mom|ups|time|top|years|election|Fourteen|class songs|039|m|Bill|The Preamble|039|m|Your|Schoolhouse Rock|Election Collection|DVD Walt Disney|Video|amp amp Audio|cartoons|songs|everything|country|SCHOOLHOUSE ROCK|ELECTION|OLLECTION|Schoolhouse Rock Election Collection Jack Sheldon|Schoolhouse Rock|Election Collection Walt Disney Studios Home Entertainment Unrated September|List Price
galatasaray|championsleague
DIVA|dayofthediva|poster|gig|Eagle Manchester|World AIDS Day|katherineellis1
BlackFriday|shopping spree|stop here|1DWorldMerch|onedirection
lukebullock|OBama
Really|Daisy|sleep police|owner|jerk store
winter mornings|Decemberwish|soppphhhh|39|cold|39
Obama|KevinHa|RP
Cyber Monday|Police Box|Tardis|blackmilkclothing
vaneycj|aids
Obama
key|morning|night|todayshow|yolo|globalwarming
Alinin|galatasaray|championsleague|cimbom|cimbombom|ultraaslan|instagram
Horse|shoes|ass|religion jeans|true
bird|seaguls|malibu|november|globalwarming
cameras|announcement|ocean acidification|WA|Seattle|tvnews|globalwarming|photographers
course|allietotheb|band aids|silver|radness
brains|history|religion amp|God
nofilter|Browns|NFL|Cleveland|GoBrowns
DecemberWish|Birthday|TqALLAH|LoveISLAM|LoveUallLillahiTaala
Obama|WhoDat|Love
now|down|Dank|Funksticks|stage|sandy|benefit
Election|night
Mohamed Mahmoud|protest|police|riot|revolution|tahrir|clashes|cairo|egypt|egyptian|me|usefsalah|ua07|march|acab|anarchy|youth|photography|photographer|photooftheday|picoftheday|instagram|instacanvas|teargas|graffiti|strong|soldiers|filmmaker|cinema|followme|chants
uniform|NFL
|||bahrain
DE LA MARQUE|religion|TAILLE|PA|PV|ADRESSE EMAIL
grandma|lady|cancer|tests|week|possibilities|prayer|today
people|religion amp|people
Bush|Obama|JEZEBEL|tcot|sgp|teaparty
theater techniques|aids|Chekov|39|Guns
city|newyork
Cotton Candy|Cairo
Young Prince|homie|cat cancer|CureFIP
Philippine|Crame Church|police
39|conquer cancer event|alexthao,|terryhe|amp|shimmycocopuffsss
dilly|chix|abortion
Pandora|advertising|election season|Obama|nonsense
BUNDLE DEAL|lavishemporium|boutique|blackfriday|blackfridaysale|blackfriday2012|thanksgiving|thanksgivingsale|cybermonday|armcandy|accessories|brazilianhair|curlyhair|handbags|idohair|isellhair|indianhair|jewelry|kinkyhair|laceclosures|malaysianhair|order|peruvianhair|quality|sale|shoes|straighthair|virginhair|virginextensions|wavyhair
Dogs|Cute|MobCam|InstaDogs|InstaAnimals|Adorable|Pets|FoundAndLost
Post|election rice|suculentBCN
newyork|m|amp m|39|s
backyard|bar|parkslope|brooklyn|newyork|brunch|egg|yolk|yum|food|foodporn
Canes|Versagram|App|vbf1|blackfriday|shopping|leftovers|text|versagram|versalove
Work|flowww|bakers|blackfriday||death
039|t|movie|birthday gift|look|RealHughJackman|decemberwish
Japan|election|vote|app
fuckoff|Zimmerman|deserve|life.|amp|photo|you|only|released|now|so|staged|lame|killer|poor|trayvon
Pra|ligatti
MemoriesIWontForget
erectiongay|gayboy|gayboys|gayguys|gaymarriage|gayrights|freedom|freelove|street|lgbt|love|onedirection|harrystyles|luoisthomilison
Teenage Cancer Trust|year|professorgreen
Subway|stories|zlbg|frsharabianluv|subway|nyc|newyork
Tokyo Gore Police Dvdrip Tokyo Gore Police|movie download Actors|Eihi Shiina Cay Izumi Mame Yamada Yukihide Benny Ikuko Sawada Itsuji Itao Akane Akanezawa Ayano Yamamoto Jiji B Tsugumi Nagasawa|molsdvceryinfo|movie|Tokyo Gore Police|New York Post Strap|boys|girls|things|very|April|Actors Eihi Shiina Ruka Itsuji Itao Keyman Yukihide Benny Tokyo Police Chief Jiji B Barabara Man Ikuko Sawada Bar|Amid|campaign|police|Tokyo Gore Police Wikipedia|encyclopedia|Tokyo Gore Police|Tky Zankoku Keisatsu|American|film|Yoshihiro Nishimura|Tokyo Gore Police|IMDb Director Yoshihiro Nishimura|people|Machine|surprise|Tokyo Gore Police|cult|Tky Zankoku Keisatsu Tokyo Gore Police Movie Reviews|Twitch|Film|Tky Zankoku Keisatsu Tokyo Gore Police Rotten Tomatoes Review|scientist|Key Man|virus|humans|abominations|nature|order|Tokyo Gore Police Netflix Tokyo Gore Police|scientist|Key Man|virus|humans|samurai sword|cop|Ruka|Tokyo Gore Police Blu|Eihi Shiina|Yoshihiro|But|039|word|master|039|class|splatter fest ends|Tokyo Gore Police Reviews|amp amp Ratings|IMDb Review|title|title
S|pode|WesleySafadao|amp|GarotaSafada!|app|android
prostate cancer|ton|tabs|Ronald McDonald
kylegibbons|jelluhfish
fans|donations|yesterday|39|food drive|HurricaneSandy|UConnCountry|BleedBlue
Lsb|lsb|girllovegirl|gay|gayboy|gayguys|gaylove|gayrights|gaymarriage|freedom|freelove|love|lgbt
airpopolice
movember|Day|movember|cancer
election day|aunt|Doad|Obama|parka
Mexes|Chilena|Francia|Italia|Venezuela|UCL|ChampionsLeague|Calcio|Futbol|ACMilan|Golazo|Gol|ForzaMilan|Rossonero
Love|religion
Hunting Trophy|quot|SWELLING|varMITT|exposeLiberal|co2hog|P2|tcot|teaparty|gop|DEMS|LIBERAL
memoriesIwontforget
money|Teenage Cancer Trust
Tahrir|egypt|tahrir|cairo|revolution|ihatemuslimbrotherhood|freedom|freeegypt|instagram|instalife
That|spawnio20|City|CL|ChampionsLeague
Equality|breakfast|gay|gayboy|gayboys|gayguys|gaylove|gayrights|gaymarriage|kissgay|freelove|freedom|lgbt
Cheeee|39|Micky|P|NewYork|newyorkcity|NYC|TimeSquare|selfie|city|micky|mickymouse
bonding weekend|daddy|BlackFriday|shopping|golf
kaka|thebest|bernabeu|championsleague|realmadrid
pantallazo|trasmisin|directo desde|Tahrir|Cairo|egipto|demo
Smile|kinggoldchains|tyga|kingcairo|SoSweet|Tyga|Cairo|King|Studio|Family|Love|Baby|LastKings|Kingin|HardWork|Small|Happy
year breast cancer helmets
Barberton|police|lady|parking lot|KMa.|police|SUV|amp|crusier|amp blocks|drugs|guns!|ticket.|taxdollarsatwork
warming|39|finest|Baltimore|GlobalWarming
Sandy Little Cheeks
Sign|abortion|clinic today|oxymoronic
Ghost|Cairo|Illinois
Repost|Election Day
paover|CountryStrong|Travis|cutie|cancer|favorite
game|nfl|nyg|gmen|football|sunday|funday
cristians|muslims|religion|church|mosk|extremist|terrorist|911|wtc|binladen|osama|osamabinladen|alqaeda|alqaida|al|mudjahedin|taliban|revolution|ignorence|nonesense
Red|White|Blue Christmas Tree|re election|President Barack Obama
bigtiggershow|Bro|Gmail|HIV AIDS Awareness Record|Interview
39|love|adventure|Rome|Newyork
Talvez|e|dizer que vai pensar e|fim vai deixar
man|Henry|cancer
New|Zimmerman|Dj Clue|voice|homie|Trayvon|fact|clown|Trayvon|toast|cops|phone
test|claims|religion|don|039|t|atheism
Hryda|onmyPboishit|thuglifer|Blackfriday|imblackeveryday|blacksheep|backonmyfeet|stillupstillaintwent2sleep|Jumma|prayerday|Rip|V12BmR
Finally|My Pro|Sex Marriage Shiis Here|FCKH8COM|gaymarriage|equality|fckh8|gay|lesbian|LGBT|39|love|39
grandmother ever|Thanks Bibi|BlackFriday|Love|Amazing
Dixie|textbookworld|religion class|uoft
Party|f|police|party
tbt|Halloween|weathermen|hurricaneSandy
NAO MOLE NAO DIRETORIA E O CANCER|VERDAO
hands|air|hands up|air|budha|religion|incense|techno|song|memories
night|D
DecemberWish|Less|Less|Less|tears|happiness|laugh|love
GEORGE ZIMMERMAN REALLY|LIFE|JUSTICE
man|Burberry|Religion|Olympics
Spending|34|34|Boo|football|nfl|cfl|football|qualitytime|putaringonit
Election
architecture|postsandy|hurricanesandy|nj
PhonseeMac|HeyBoo|quot||YouLoveShauna|cancer bf|039|other|quot
justinbieber|Obama
Decemberwish|december|ig|igers|igdaily|photodaily|mymonth|hashtags|nofilter|tweegram|instagood|instagram|instamood|instalikes|instaphoto|instafamous|instafollow|followforfollow|likesforlikes|f4f|l4l|10likes|smile|happy
39|gas problem|NYC|sandy|ny|nyc
bitches|em|repost|dat|nigga mase|Magic|Johnson|HIV|Aids|OhBabyiLikeItRaw
joke|fantasy|abortion|flop|nfl|fantasyfootball
Deliveries|Snacks|pinkelly|oreos|hurricanesandy
Funny|Football|CyberGift|Troops|ISS|Seahawks|Journey|journal
tree|snow|ig|igers|instagram|fallentree|hurricanesandy|sandy|winter|autumn|seasons|jj|photooftheday|likeforlike|picoftheday|leaves|cold
months|Election|later|haven|39|t|TrayvonMartin
{}
collection|hellokitty|newyork|shotglass
religion
39|FashionablyDelicious|oakville|cancer|fundraiser
BlackFriday|purchases|mall|lol|sephora|freshfounder|lushvalleyfair|julepmaven
Obama|Aughhhhh|Kingcairo
39|Direction|39|Congrats|Direction|39|re|Directioners|Ovarian Cancer
problems|mitt|39|t|tee|Obama
PARIS SAINT GERMAIN|PSG|PSGPORTO|C1|Championsleague|Win|Paris
election predictions
AIDS Project Los Angeles World AIDS Day|FoodDrive|Sat|Info|aplaorg|fooddrive
breast|cancer|awareness|soccer|game|vsyulee|november27th|bethere|shootout|prizes|530|720|wearpink
Tahrir|square|Today|27November2012|protest|revolution|Tahrir|Square|Cairo|Egypt|tahrirsquare|brutal|police|force|teargas|gas
MESSAGE|PRESIDENT AT STARBUCKS
Por|nios|cancer|karemcitac|pabloacap
Ladies|Lady|firstlady|obama|michelleobama|merica|usa
girl|abortion|one|abortion|34|34|34|abortion|34|mon|consultation tues|procedure wed|at|GTFOH|TheThirst
day|MemoriesIWontForget|Graduation2011|unibocconi
read|tonight|AudacityOfHope|Obama|BarackObama|ProudDad
decemberwish|Oppa
Souls|spirit|days|tahrir|egypt|cairo|travel
039|ve|anti|Obama FB|page|cousins quot|quot|guy|039|name|Joe Dirt
Rap|Religion|book release party||Diplomat
revenge antagonise football fans
Flag Football Skills Clinic
GoT|Cast|Cast|Game|Thrones Premiere|SF|BM0Jh4QYkU
telltalegames|smokes|Game|thrones|Amaaaazing|job
SarahSarah256|WinceyWillis1|India|percentage|millionaires|animals
dallxscxm|YourBoyMyles|animals
InnovativeHindu|ndtv|Headlinestoday|Muslim Org PFI|Hindu Temple|Calicut Kozhikode|Sunday
Football Season
RyanBrownWJOX|JayHopeIsHere|Joey35209|UABOT|UAB|football program down|man
JeffSolochek|Florida|superintendents|school board members|testing|concerns|recommendations|ErikaDonalds|edFL
SteveStfler|BRUH|EDUCATION SYSTEM|SkMUpn61jb
SDLPlive|SDLP|action|poverty|living wage|Ulster|council|Mencap|NI
AnishNation|Job|opportunity|Education Development Officer Nipissing Campus|sharethis
Robby Ratan|avatars|education.|MSUComArtSci|MSU|ITL
NYSenate|New Yorkers|NYGovCuomo|education agenda|legislator now
RTeNnDFVuu|Sale|Allen|Edmonds GRIDIRON Oxfords|D Brown Football Grain Leather
StPetePD|arrest|animalcruelty|animals
version|Game|Thrones Bingo|sale|https tco|SteyDsxjem|GameOfThrones|GRRMspeaking
Photos|Bollywood Stars|WwGkNRZsai
JeanneBartram|Iain Duncan Smith|food bank charity|bankers|poverty
zepvv|football|potential|t
allthelovelouis|football game|cheerleading|sidelines
90sfootball|James Richardson|cafe|papers|Football Italia
angela|std Animals|ApoyoLeyAnimal087|U9lzybxi1o
EssexFBU|Brigade|reps|FBU|education course|WortleyHall|suppo|EssexFBU|Control|staff pledge donations|NotGoingAway
Baylor|football|Texas
Daily Bread|poverty|hunger|WhyWePray
Education|costs money
University|Saskatchewan|students protest|tuition fees|call|education|VxPbn35nWy
rightsnet|Iain Duncan Smith|food bank charity|TrussellTrust
ORGY PORGY European Invasion DNA|Origins|Modern Europeans IFLScience
Japan|technology transfer pacts|Reserve Bank|India|Jgr8utquw1|ZbnoUr7oO7
MindyRosier|Public Education Warriors Unite|AllKidsNeedht|quadgurl|CMZR|RodneyJordan4|TruthinTeaching|teachin1100
philo|paof education|training|nursery|Plato
NationalAwards|actor|Priyanka Chopra|town girl|Kangana Ranaut
violence|womans|dependence|man|woman education shell|man|livelihood
Ki Baat|talk|heaby|Prime Minister Narendra Modi|All India Radio News
outlawvern|comment|S GOTTA|today|HOLLYWOOD SHUFFLE|smash
Hollywood|dneedles12|repofrom|LA|tonight|WISN12News|Badgers|Sweet16
Okies4Carrie|Carrie Underwood|Hollywood Bowl Surprise Guest Mr|Randy Travis WOW|Amazing
NBCLA|WillFerrell|Hollywood|Fame|star|celebrates|family
RevRichardColes|Paul Hollywood|mille feuilles|day|m
Hollywood|Star|Interview Magazine January|Julia Roberts Tim Robbins Laurence Fishburne|XaXZK2IFRq|BestSeller|eBay
A List|celebrity|Kim Kardashian Hollywood
BrooksBeau|Hollywood|weed
Mr|Hollywood|Deal|Thursday|March|event|reminders|gluten
JBCrewdotcom|Photos|Justin Bieber|West Hollywood|CA|March|tco
dollllllfaceee|Kim Kardashian Hollywood
TheAegiMaster|Harlem|Hollywood|Jackson|Mississippi
Singer|Actress|Breakout|MileyCyrus|CD,|Jul|Hollywood|Bids End Date|Deals|Bargains
Lady9NewOrleans|thing|Hollywood|history|men|roles
Iam1izzo|S O|LeoDiCaprio|R B|celebrities|Hollywood|YoungHollywood|NextUp|Movies|etnow|TM
DuncanWhitehead|whodunnit|mystery|books|decade|Hollywood Times|kindleespaol|kindleunlimited|kindle
jesu|Young Hollywood|celebrity|content|Apple TV Apple TV|celeb|CUzAu8w5ho|paulz
Big12SportsESPN|Hollywood|dneedles12|repofrom|LA|tonight|WISN12News|Badgers
jesu|Young Hollywood|celebrity|content|Apple TV Apple TV|celeb|paulz
JOPDreke|Secret|Liam|Hollywood Celebs|Muscle Gains|XhzqBo0j9h
HOLLYWOOD COLLAGE POSTER|ARTWORK
JColeNC|Forest Hills Drive Tour|Act|Hollywood|Sean|YG|Jeremih|J4fT33Z8dT
Queens|Stone Age|One|Cranberries Hollywood
teresaamejiaa|stars|Kim K Hollywood|trick LINK|PROFILE
B List|celebrity|Kim Kardashian Hollywood|M
Hollywood Free Games|Kim|Hollywood|Game
NerdPowersUnite|Lady9NewOrleans|thing|Hollywood|history|men
E List|celebrity|Kim Kardashian Hollywood
millions|Hollywood Film TV|millions|music moguls|biz turn
ayeeitsbeccaa|Stars Cash Kim Hollywood|FREE|Check Detail Secrets|Bio Profile
dollfacetrece|Tricks|Stars Cash Kim Hollywood|FREE|Check Detail Secrets|Bio Profile
hamilt4|Stars Cash Kim Hollywood|FREE|Check Detail Secrets|Bio Profile
Indiegogo|kickstarter|Hollywood|movie trailer|growthhacker
Movie Finance|Hollywood|TOMOOffMarket
VanityFair|Birthday|Steve McQueen|definition|Hollywood Cool
Iam1izzo|S O|LeoDiCaprio|R B|celebrities|Hollywood|YoungHollywood|NextUp|Movies|etnow|TM
TheAVClub|ep|ComedyCentral|series|Time|Hollywood|FL
ADeco Old Hollywood Affair Wedding Decor|flowers|feathers
ArkansasAuthors|AceCollins,|author|Man|Hero|Hollywood|JupR5tBR6q|E63HHDo0Qp
Highway|Hollywood Trailer|ZkCbVaRpeh|YouTube
GOPLdrBrianKolb|millions|Hollywood Film TV|millions|music moguls|biz turn
ATTI|ML04orange|Bus|Sam|Club|Orange South|Next Stopis Hollywood|Domain Apts|PM
Monatana Ave|St|Beauticate|SantaMonica|Hollywoods|cousin
YouTube|video|kiss|network|Hollywood Traincase LOLA V
HOLLYWOOD THEATER ROW|Hollywood East Hollywood Chamber|Commerce
TheAVClub|ep|ComedyCentral|series|Time|Hollywood|FL
|Akanshagautam Meanders|Mike Reyfman|Applebees|Landscapes|Photography|Nature|Travel|S2Y3DvCKBz
archeteer|vic|Pascual|photography|architecture|Santiago Calatrava City|Arts|Sciences|ValenciaSpain
post Photography books|Exposure|YU3VfQMlex|itslikereally
AUTOUPDATED Blogger|blogs|FREE|C4n9ygFb8d|Stup
|Akanshagautam Meanders|Mike Reyfman|Applebees|Landscapes|Photography|Nature|Travel|S2Y3DvCKBz
Photography Tutorials|Here|Trick Photography|Effects|tco|p8p9yjxqOL|Libros
monicatakvam|CALL|ENTRIES Renaissance|Photography|Prize|RPP2015
Page|Trust|photography|advice
Network|Landscapes Photography Qualasha|mikeshoys|landscapes
Life|photography|negatives
ExclusiveTailor|K|Photography
CutPics|Microscopic Photography
56396|product|nighter sunrise|neighbouring roof|Leicester|photography|sun|C9bckqodK3
UK Highland Photography|review|produ|tco|NUkfLCPmKn|yotpo|CkbdLMtOAV
DWAWest|adventures|picoftheday|Newhaven|Sussex|photography|landscape|blackandwhite|Leica|tco|3FxsEKZL6S
Susanne|backdrop|Carl Hult|UhfA9nXuTB|YouPic|photography|PIcSher|TeamCanon
GORILLA MONSOON|XIII PHOTOGRAPHY
Love|love|candy|photography|ellahaus|wedding|candybar|vancouverwedding|ttps|tco|R6jgv7SJjC
OnePerfectShot|LAWRENCE|ARABIA|Director|Photography Freddie Young Director David Lean|OiOGgSj83q
AnnieLyden|Martin Barnes|V|talk|S African|photo tomorrow|NatGalleriesSco.|NGSPonteCity
Springtime Fly
Director|Photography Bryan Pereira|Scarborough|Club Ontario
mainlygems|photography student|easy|expenses|ass|hand|cup
classes|school|choir photography
ggwildlife225|thought|WildLondoner|WWTLondon|London|Wildlife|Photography
Done|MatHombauer|brand|conce|photography|flickr|group|Hzi9UkRTt8
book|photoshoot|nigga|Active|Photography
RFWPPI|wedding|portrait|photography|conference expo reports growth|measure|EuK8IhSr8t
Growth|Video|Photography Business|Fstoppers|tco|bOUCqctV2d
Examples|Fashion Photography|images|MBmLr7ly1E
Brand|Saturated|Photography|Market Tips|A|Pd2tw4fBhD
DWAWest|adventures|picoftheday|Newhaven|Sussex|photography|landscape|blackandwhite|Leica|tco|3FxsEKZL6S
RFWPPI|wedding|portrait|photography|conference expo reports growth|measure|UuA22bGanK
photography
P41 Eisbrecher|Director|Photography|MWVdnsp1FO
jasonburrows|Landscape|Loon Island Lighthouse
photography|photoofthed
aof flower photography Mother|Nature Network|blog|QUqJNMMtVe
Viewpoint|Angles|Photography
advice|tco|OQSExrRGKD|photography...
night photo shoot
kapchur|photography|natural|canon|freelance|photos|videography|ttps|tco|tdMPD6GOk1
|Akanshagautam Meanders|Mike Reyfman|Applebees|Landscapes|Photography|Nature|Travel|S2Y3DvCKBz
A1|EarthHourSA,|Tourism|conf|CT|ODdRMEEIPG|EHchat
WalesAirForum|Roger Lewis|Cardiff Airpochairman|FCUhP0drq8|Cardiff|Wales|avgeek|WalestotheWorld|
tibettruth|travel|trueTibet?|tourism|erosion|Tibetan|culture
tibettruth|trueTibet|landscape|tourist|theme park|China|terrorist regime|travel|tourism|tco|F
Tourism|country|skies|observation worldwide|ast
tibettruth|trueTibet|landscape|tourist|theme park|China|terrorist regime|travel|tourism|tco|F
CatalanMuseums|Catalan Museum|souvenirs|idea|tourism|visitors|Don|f
SA|Tourism|role|sustainability|EarthHourSA|EHchat
hany2m|tourism|Egypt|increases|pct|Jan CAPMAS
tour|Skills Development Programme|Wakkerstroom Tourism
Turismo,|Zaia|presenta|SmaGuide Tourism|Vinitaly
WWFSouthAfrica|SA|Tourism|role|sustainability|EarthHourSA|E
geckobike|idea|tourism|Tibet|form|terms|ethics
Iran|Photos|trips|Shiraz|Hafezieh|Nowruz|holidays
Tourism|Iran|MustSeeIran
Morning|ijen|Crater|East Java|Indonesia|tourism|eastjava|holiday|kids|Indonesia|ttps|tco|r1ikfMU4Xb
Atlantic City|tourism push|entertainment
ac|atlantic|jersey
RoyalMuseumJo|Tourism|Jordan|ShareYourJordan|LoveJO|GoJordan|VisitJordan
Manchester|day|tourism|sightseeing
AnasAlShariff|RoyalMuseumJo|Tourism|Jordan|ShareYourJordan|LoveJO|GoJordan|VisitJordan
tourism survey|growth|jobs|tourism sector|busin
meta|guide lc|St|Lucia|Record|Tourism Growth
AnasAlShariff|RoyalMuseumJo|Tourism|Jordan|ShareYourJordan|LoveJO|GoJordan|VisitJordan
taxi driver|Artane|place|guy|job|tourism board now
Places|United States
th3programe|Places|United States
njerudeee|Security|fears|Kenya|Tanzanias|favor|tourism
TOURISM WEBSITE
Dmitris Tsoukalas|iamanathenian|company|tourism|Athens|Greece|SoMeT15EU|PIUG2v0Uzi
photo|indonesia tourism|Street|Gunung|ZODGYznjyO
London Mayor Boris Johnson|tourism|gems|London|Evening Standard
CCCU|hospitality|tourism|logo comp|logoideas||entchoices
EstherPassaris|AMB|Mohammed|tourism sector|pride|nature beauty
spring|Kurokawa Onsen|introduction|Tokyo Olympics Japan Tourism Video|Olympics
th3programe|Places|United States
masterclassing|seat|Digital Travel|Tourism Masterclass|Dubai|April
North East|Gov|tourism
masterclassing|Tourism|brands|relationships|audience|Brandwatch|Pj
th3programe|Places|United States
Iran|Photos|trips|Shiraz|Hafezieh|Nowruz|holidays
Tourism|Iran|MustSeeIran
Post|Nigeria|tourism|referral hospitals|Post Nigeria|Bxnbm6TI1g
BittuSahgal|Rwanda|tourism|communities|India|leaf|book
Post|Nigeria|tourism|referral hospitals|Post Nigeria|YPAIajvteW|WeTriumphStill|IchooseGEJ
Head|School|Hospitality Management|Tourism|future|tourism|Ireland
oleebranch|Kyaninga Triathlon|Mighty Rim|UGblogs|256Blogs|VisitUganda|Triathlon|Fitness|Fitfam|Ad
Humber East Liberal|stelmanflynnMHA|studio|businesses|tourism guide|YocziqhF6v
Tourism|Barcelona|B6vvmzkehO
